%%%%%%%%%%%%%%%%%%%%%
%                   %
%    % % % % % %    %
%   %           %   %
%  %             %  %
% %               % %
%                   %
% %               % %
%                   %
%M%      E        %M%
%                   %
%                   %
%                   %
% %               % %
%                   %
% %               % %
%                   %
% %               % %
%                   %
% %               % %
%%%%%%%%%S%%%%%%%%%%%