%%%%%%%%%%%%%%%%%%%%%
%E  %         %     %
%      %         %  %
%   % % % % %     % %
%%         % %   %  %
%     %             %
%      % % % %   %  %
% % %     %   %     %
%    % %         %  %
%   %     %       %M%
%  %   % %   % %    %
%     % % % %       %
%% % %              %
%       %   %       %
%%     %            %
% %   %   %  M%     %
%              %    %
%           %       %
%  %                %
%   % %   % %       %
%%%%%%%%%%%S%%%%%%%%%