%%%%%%%%%%%%%%%%%%%%%
S %     % %   %     %
%              %    %
%     % % %   %   % %
%%           %   %  %
%   %   %  E    %   %
%  %   %   %       %%
% %   %     %       %
%%       %   % % %  %
%   % % %       %   %
%    % %   %        %
%       %           %
%    %   %       % %%
%   %          M    %
%              %   %%
%   %           %M  %
%%   %              %
%     %           % %
%%     % %          %
%         %         %
%%%%%%%%%%%%%%%%%%%%%