%S%%%%%%%%%%%%%%%%%%%
%          M    %   %
%%   %       %      %
%                   %
%            %     %%
%             %     %
%%     % %         %%
%         %         %
%  %         %     %%
% %   %             %
%% %         %      %
%            E      %
%  % %     %     %  %
%         % % %  M% %
%  %       %   %    %
%       %           %
%% %             % %%
% %   %             %
%    %           %  %
%       %       %   %
%%%%%%%%%%%%%%%%%%%%%