%%%%%%%%%%%%%%%%%%%%%
%M                 M%
%                   %
%     %             %
%    %              %
%                   %
%                   %
%                   S
%    %              %
%        E          %
%    %              %
%                   %
%                   %
%                   %
%                   %
%                   %
%    %              %
%     %             %
%                   %
%M                 M%
%%%%%%%%%%%%%%%%%%%%%