%%%%%%%%%%%%%%%%%%%%%
%   %           % % %
%                   %
% %E%               %
%      %       % %  %
%   %             % %
%%               %  %
%       %       %M% %
%  % %     % %      %
% %   % %           %
%%               %  %
% % % %   %     % % %
%                   %
%       %     %     %
%        %     %   %%
% %     % %   % % % %
%%   %              %
%M% %               %
%    %     %       %%
S               %   %
%%%%%%%%%%%%%%%%%%%%%