%%%%%%%%%%%%%%%%%%%%%
%     %             %
%  %                %
%        M  %       %
%                  %%
%  E% %       %     %
%              %    %
%   % % %   % % %   %
%  %                %
%           % %M    %
%        % % %     %%
%         %     %   %
%    % %   %        %
%         % %       %
%            %      %
% %   %             %
%    % %   %   %    %
%     %   %         %
%%         %        %
%                   S
%%%%%%%%%%%%%%%%%%%%%