%%%%%%%%%%%%%%%%%%%%%
%M     M           M%
%                   %
%                   %
%       %    % %    %
%             %     %
%                   %
%     %             %
%                %  %
%        E          S
%         %         %
%                   %
%    %              %
%           %       %
%                   %
%        %          %
%          %        %
%     %             %
%               %   %
%M     M           M%
%%%%%%%%%%%%%%%%%%%%%