%%%S%%%%%%%%%
%       %   %
%           %
%   %      E%
%      %    %
%           %
%           %
%           %
%  % %     %%
% %         %
%        %  %
% %M        %
%%%%%%%%%%%%%
