%%%%%%%S%%%%%
%           %
%      % %  %
%     %  M  %
%      %    %
%         % %
%           %
%   %       %
%           %
%        E  %
%           %
% %         %
%%%%%%%%%%%%%
