%%%%%%%%%%%%%
S %         %
%           %
%  M        %
%  %   %    %
%   %   %   %
%    % %    %
%     % %   %
%  %     %  %
%  E%   %   %
%  % % %    %
%           %
%%%%%%%%%%%%%
