%%%%%%%%%%%%%
%           %
%    %      %
%E    %     %
%        %  %
% %     %   S
%           %
%           %
%  %       %%
%   %     % %
%           %
%  M        %
%%%%%%%%%%%%%
