%%%%%%%%%%%%%
%           %
%  %   %    %
%  E%       %
%  % % %    %
%         % %
%  %     %  %
% %M%       %
%    %     %%
%           %
%  % % % %  %
%     %     %
%%%%%S%%%%%%%
