%%%%%%%%%%%%%
% % %       %
%    %     %%
% %   % %   %
%    %      %
% %  E    % %
%  % %     %%
%       % %MS
%    %      %
%       %   %
%  %   %    %
%           %
%%%%%%%%%%%%%
