%%%%%%%%%%%%%
%E          %
%        %  %
% %         %
%  % % %    %
% %   %     %
%      %   %%
% %         %
%    %      %
%           %
%    % %    %
%        M  %
%%%%%%%S%%%%%
