%%%%%%%%%S%%%
%M          %
%    %   %  %
% %         %
%        %  %
%    E  %   %
%%   %   %  %
% %         %
%      %    %
% % %       %
%    %      %
%     %     %
%%%%%%%%%%%%%
