%%%%%%%%%%%%%%%%%
%       %     % %
%  %       %    %
% %    E  % %   %
%%     %        %
%       %   %   %
%               %
%       %       %
%              %%
%       %       %
%  % %   %   % %%
% %       %     %
%          % %  %
%      M        %
%  % % % %   % %%
% %             %
%%%%%%%%%%%S%%%%%
