%%%%%%%%%%%%%%%%%
%       %     % %
%        %   %  %
%   % %     %   %
%    % %     %  %
%            M% %
%  %       %    %
%   %       %   %
%  %            %
%   % % % %     %
%          %    %
S   % % %   % % %
%  % %   %      %
%               %
%%           %  %
%   %          E%
%%%%%%%%%%%%%%%%%