%%%%%%%%%%%%%%%%%
S     % %   %   %
%    %   %      %
%   %  E%   %   %
%        %      %
%M  %       %   %
%      %   %   %%
%               %
%%         %   %%
%       %   %   %
%          %   %%
%   %   % %     %
%    %   % %    %
% %       %     %
%%       %      %
%     %         %
%%%%%%%%%%%%%%%%%