%%%%%%%%%%%%%%%%%
%               %
%      % %      %
% %             %
%  %            %
%   %   %   %E  %
%          %   %%
%         %   % %
%               %
%           %   %
%               %
%       %     % %
%%              %
%             % %
%               %
%      M    %   S
%%%%%%%%%%%%%%%%%