%%%%%%%%%%%S%%%%%
%     %M%       %
%          %    %
% % %     %   % %
%               %
%   % % % %     %
%    %          %
%   %   %     % %
%      %        %
%       %   %   %
%        %      %
%  E          % %
%  %     % %   %%
%   %     %     %
%               %
% %             %
%%%%%%%%%%%%%%%%%
