%%%%%%%%%%%%%%%%%
%     %   %  M  %
%  % %     %    %
%       %   % % %
%% %     % %    %
%     %   %    M%
%    %       %  %
%     %        % %
%    %   %      %
%       %E      S
%%             %%
%     %     %   %
%      %        %
%   %         % %
%              %%
%               %
%%%%%%%%%%%%%%%%%
