%%%%%%%%%%%%%%%%%
%   %       %   %
%%             %%
%E%     % % %   %
%    %          %
%   %       %   %
%      % %      %
%       %     % %
%  % %     %   %%
%       % %     %
%%         %   %%
%   % % %M%     %
%  %         %  %
%   %   % %   %M%
%  %       % %  %
% %             %
%%%%%%%%%%%%%S%%%
