%%%%%%%%%%%%%%%%%
%   %           %
%              %%
%             % %
%  %         %  %
%          E    %
%    %          %
%     %         %
%%       %      %
%       % %M    S
%               %
%   % %   %     %
%          %    %
%   %           %
%  %       %    %
%     %         %
%%%%%%%%%%%%%%%%%