%%%%%%%%%%%%%%%%%
S             % %
%            %  %
% %   %       % %
%%     %        %
%         %     %
%  %            %
%               %
%%              %
%   %      E    %
%    %   % %    %
%           %   %
%               %
%             % %
%  %            %
% %    M        %
%%%%%%%%%%%%%%%%%
