%%%%%%%%%%%%%%%%%
S               %
%  %            %
%             % %
%      %   %    %
%       %       %
%        %      %
%           %   %
%      % % %   %%
% %          E  %
%          %    %
%   %     %     %
%  %       %    %
%   % %       % %
%            %  %
%    M  %      M%
%%%%%%%%%%%%%%%%%
