%%%%%%%%%%%%%%%S%
% %       %     %
%    % % % %   %%
%               %
%      %     % %%
%     %   %     %
%    %          %
%         %     %
%    %       %  %
% %   %   %M  % %
%          % %  %
%       %     % %
%      %        %
%     % %    E  %
%  % %          %
%             % %
%%%%%%%%%%%%%%%%%
