%%%%%%%%%%%%%%%%%
%    M          %
%      %        %
%   %     % %  M%
%%              %
%     % % %     %
%  %            %
% %             %
%        % %    %
%   % %         %
%    %   %   %  %
%         %   % %
%  %   %   %    %
%     %   %     %
%  %           %%
%E    % %   %   %
%%%%%%%%%%%S%%%%%