%%%%%%%%%%%%%%%%%
% %       %     %
%  % %   %      %
%     %         %
%%              %
% %   %         %
%  %   %        %
%  M%   % %     %
%              %%
% %  E        % %
%  %   % % %    %
%   %           %
%    %     % %  %
%   %     %     %
%    %   %      %
%  %    %     % S
%%%%%%%%%%%%%%%%%
