%%%%%%%%%%%%%%%%%
%  M            %
%  %     %      %
%     % %     % S
%               %
%     % % %   % %
%%     %   %    %
% %     % % %  M%
%    %     %   %%
%     % % %  E  %
%%     % %      %
%     %         %
%%     %        %
%   %     % %   %
%%     %   %    %
%       %       %
%%%%%%%%%%%%%%%%%
